map:
QQQQQQQQQQQ
QQQQQQQ@  Q
QQQQQQQ   Q
QQQ       Q
QQQ       Q
QQQQQQQQ  Q
QQQQQQQQ  Q
QQQQQQQQ  Q
QQQQQQQQ  Q
QQQ       Q
QQQ       Q
QQQQQQQQQQQ