map:
QQQQQQQQQQQQ
Q@QQQQQQQQ Q
Q QQQQQQQQ Q
Q  QQQQQ   Q
Q  QQQQQ   Q
Q  QQQQQ   Q
Q  QQQQQ   Q
Q  QQQQQ   Q
Q          Q
Q          Q
QQQQQQQQ   Q
QQQQQQQQQQQQ