map:
QQQQQQQQQQQ
QQQ@      Q
QQQ       Q
QQQQQQQQ  Q
QQQQQQQQ  Q
QQQQQQQQ  Q
QQQQQQQQ  Q
QQQQQQQQ  Q
QQQQQQQQ  Q
QQQ       Q
Q         Q
QQQQQQQ   Q
QQQQQQQ   Q
QQQQQQQQQQQ